#####################
#        X    #     #
####### ### ### ### #
#     #   #     #   #
# # ### # ######### #
# #   # #     # #   #
# ### ####### # # ###
#   #     # # # #   #
### ### # # # # # # #
#     # #     #   # #
# ##### ########### #
# #   #     #       #
# ### # ### # ##### #
#     # #   #   #   #
# ####### ##### # ###
# #       #   # # # #
# # ####### # ### # #
# #     #   # #   # #
# # ##### ### # ### #
# #       #   #     #
########### #########