#########################################
# #   #   #   #   #X      #   #   #     #
# # # # ### ### ### ##### ### # # # # # #
# # #   #   #   #   #   #     # #   # # #
# # # ### ### ### ##### ##### # ##### # #
#   #     #       #   #   #   # #     # #
# ######### ######### # ### ##### ### # #
# #       #   #       #   # #   #   # # #
# # ### # ### # ##### # # # # # ### ### #
# #   # #     # # #   # #   # #   #   # #
# ### # ### ### # # ### # # ##### # # ###
#     #   #     # #   # # #   #   # #   #
### ### ######### ##### # ### # ####### #
# # # #   #   # #       #   # # #       #
# # # ### # # # ### ####### # # # ### ###
# # #     # #       #       #   #   # # #
# # ### ### # ### ### # ##### ##### # # #
# #   #   # # #     # #     #   #   # # #
# # ##### # # # ### ####### ### # ### # #
# # #   # # # #   #   #   #   # # #   # #
# # # # # # ######### # # # # # ### # # #
# # # # # #   #   #   # #   # #   # # # #
# # ### # ### # # ########### ### # # # #
# #     #   #   #   #   #   #   #   #   #
# # ####### ####### # # # # ### ##### ###
# #   #     # #   #   #   #   # #   #   #
# ### # ##### # ####### ##### # # # ### #
# #   #     #       #   # #   #   #   # #
# # ##### # ####### # ### # ######### ###
#   #     #         #   # #   #     #   #
####### ##### ######### # ### # ####### #
#     #   # # # #   #   #     #   #   # #
# # # ### # # # # # # # ######### # # # #
# # #     #   #   # # #   #     #   #   #
# # # ####### ### # # ### ##### ##### ###
# # #       # #   # #   # #   #     #   #
# ### ##### # # ### ##### # # ### # # # #
#   # #   # #   #     #   # # #   # # # #
### # # ### ##### ##### ### # ### # # # #
#   # #     #       #   #   #     #   # #
##################### ###################
